#############################
#            3              #
#   #     AAAA   2 #       A
#             #             C
#      A  #  C  #  B        #
#   #     #     #     #     #
#  AA          C      C     B
#                           C
#              1            C
###########ABCBAB############
