####################
#                  #
#   #        A     #
#   #   1    A     #
#   #        A     #
#   #########      #
#         #        #
#    2    #        #
#         #        #
#   ####BBBBB      #
#   #        #     #
#   #   3    #     #
#   #       CCC C  C   
#                  #
####################