########################
#          #           #
#   ####   #     ##    #
#   #      #           #
#   #   ###########    #
#   #                  #
#   ######   #######   #
#                      #
#      ##              #
#          ######      #
#    ##                #
#          #           #
#          #           #
########################
