########################
#          #           #
#   ####   #     BB    #
#   #      #           #
#   #   #######CCCC    #
#   #                  #
#   ######   #######   #
#                      #
#      ##              #
#          AAAAAA      #
#    BB                #
#          B           #
#          B           #
########################
