####AAAA#######
#             #
#   1     A   A
C   BBBB      A
C      B      A
C   2  B   3  #
C      B      #
#   CCCC      #
#      C      #
###############

